1111111111111111111111111111111111111111
1000000000000000000000000000000000000001
1040000000000000000000000000000000000001
1110000000000000000111111111111111100001
1000000000000000000110000000000000000001
1000000000000000000110000000000000000001
1111111111111110000110000000000000000001
1000000000000000000110000111111111111111
1000000000000000000110000000000000000001
1000000000000000000110000000000000000001
1000011111111111111110000000000000000001
1000000000000000000111111111111111000001
1000000000000000000000000000000000000001
1000000000000000000000000000000000000001
1111111111111110000000000000011111111111
1111111111111111111000000000011111111111
1000000000000011111000000000000000000001
1000000000000011111111110000000000000001
1000000001111111111111110000000000000001
1000000000000011111111111111100000000001
1000000000000011111111111111100000000001
1111000000000000000000000000000000000001
1000000000000000000000000000000000111111
1000000000000000000000000000000000000001
1000000000000000000000000000000000000001
1111110000200030030030000001111100000001
1000000000000000000000000000000000000001
1000000000000000000000000000000000000001
1000000000000000000000000000000000000001
1111111111111111111111111111111111111111
