11111111111111111111
10000000000000000001
10000000000000000001
11100000000000000001
10000000000000000001
10000000000000000001
11111111111111100001
10000000000000000001
10000000000000000001
10000000000000000001
10000111111111111111
10000000000000000001
10000000000000000001
10000000000000000001
11111111111111111111
